00000000000000000000
00000000000000000000
00010000111100001000
00010000000000001000
00011110000001111000
00000000111100000000
00000000000000000000
00010010000001001000
00010010000001001000
00010010000001001000
00020000333300002000
00020000333300002000
00010010000001001000
00010010000001001000
00010010000001001000
00000000111100000000
00000000000000000000
00000000000000000000
00000000000000000000
00000000000000000000
