00000000000000000000
00000000000000000000
00010000020000001000
00002000000000020000
00000000000000000000
00000000020000000000
00000000000000000000
00000000020000000000
00010010000001001000
00000000000000000000
00030001000100003000
00030000020000003000
00000000000000000000
00010010000001001000
00000000000000000000
00000000020000000000
00000000000000000000
00000000000000000000
00000000000000000000
00000000000000000000
